x....................f
x....................f
x....................f
x....................f
x....................f
x....................f
x......e.............f
xs.....xx............f
xxxx.......e....e...xx
xxxxhhhhhhhxxxxxxhhhxx