x....................f
x....................f
x....................f
x....................f
x....................f
x....e.........e.....f
x....xxx......xxx....f
xs...................f
xxxx........e.......xx
xxxxhhhhhhxxxhhhhhhhxx