x....................f
x....................f
x...........e.c......f
x...........xxx......f
x.....e.c............f
x.....xxx.....e.c....f
xs............xxx....f
xxxx.................f
xxxx..e.c...........xx
xxxxhhxxxhhhhhhhhhhhxx