x....................f
x....................f
x....................f
x....................f
x....................f
x.............xx.....f
x.....xx.............f
xs...................f
xxx..................f
xxxhhhhhhhhhhhhhhhhxxx