x.....................
x.....................
x.....................
x.............xx......
xs............xx.....f
xxxxx....xx...xx....xx
xxxxxhhhhxxhhhxxhhhhxx