x......................................f
x......................................f
x......................................f
x......................................f
x......................................f
x.............xxx......................f
x.....xxx..............................f
xs.........................xxx.........f
xxx..................................xxx
xxxhhhhhhhhhhhhhhhhhxxxhhhhhhhhhhhhhhxxx