x......................................f
x......................................f
x......................................f
x......................................f
x......................................f
x.....e................................f
x.....xxx..............................f
xs..........................xxx........f
xxx........e...e.....e................xx
xxxhhhhhhhhxxxxxhhhhhxxxhhhhhhhhhhhhhhxx