x......................................f
x......................................f
x.c.e.......e.c........................f
x.xxx.......xxx........................f
x.....e.c..............................f
x.....xxx.....e.c......................f
x..c..........xxx...........e.c........f
x..xx.......................xxx........f
xs....e.c..........ce.ce............c..f
xxhhhhxxxhhhhhhhhhhxxxxxhhhhhhhhhhhxxxxx