x......................................f
x......................................f
x......................................f
x......................................f
x......................................f
x.....e................................f
x.....xxx.................e.......e....f
xs........................xxxxxxxxx....f
xxx........e...e.....e.................f
xxxhhhhhhhhxxxxxhhhhhxxxhhhhhhhhhhhhhxxx