x......................................f
x......................................f
x.c.e.......e.c........................f
x.xxx.......xxx........................f
x.....e.c..............................f
x.....xxx.....e.c......................f
xs............xxx...........e..........f
xxxx........................xxx........f
xxxx..e.c...........ce.c.............xxx
xxxxhhxxxhhhhhhhhhhhxxxxhhhhhhhhhhhhhxxx