x......................................f
x......................................f
x......................................f
xs.....................................f
xxx....................................f
xxx....xx..............................f
xxx....................................f
xxx...........xx...............xxx.....f
xxx....................................f
xxxhhhhhhhhhhhhhhhhhhhhhxxxhhhhhhhhhhhxx