x...............................................f
x...............................................f
x...............................................f
x...............................................f
x...............................................f
x.....e.........................................f
x.....xxx...................e......e............f
xs..........................xxxxxxxx............f
xxx........e...e......e..................e......f
xxxhhhhhhhhxxxxxhhhhhhxxxhhhhhhhhhhhhhhxxxhhhhxxx