x.....................
x.....................
x..xxxx...............
x.............xx......
x.x...................
xsx...................
xxxxxhhhhxxhhhhhhhhhxx